n g v v n n g n g n
v g n g v g g v g v
h v v g v v g g h v
v n g g g g h n g g
g v v v v n w w w w
g v v h v v h g v v
g h n v g g g n v n
g g n g g g g g v h
v v h g v v h n g v
g g v v g h g g g g