h f f f i h f f i f f f f f f
i i f i f f f h f f i i i f i
h f f f f i f i i f f f i f i
f h f f i f i f i f h i f i i
f f i f i i i i f f f f f i h
f w w f w w w f f f w w w h w
f i i i f f h f f f i i i i i
f f i f f f h i f f i f f f f
i f f i f i f i i i i f f i h
f f i f f i i i i f i f i f i
f i h f f i f f i i i f i h i
i i i f i f f f i f f f f f f
f f i h f f i h f i f i h i i
f i i i h f f i h h f i i i i
i f h f f f i h f i h h f i i