v v v g g v h g v v
h h h g v v h v v n
n v g g g g g v v g
h n v v g g g h n v
g n v v g g g g n v
n v v v v h v g g v
v n v v n v g v v v
g h w g g v v w v w
v h g h g h v n v v
v n v v v n n h g v