r r p r y y r r y r
r y y r y r r y r y
l l y y y r l y y l
r y y r y y y r p r
p y r r r y y r r y
r y r r r y r y r r
y r r y r r y r y r
y r r y r r r r r r
y r r r y r y p p y
r r y y r r r r r y