w g g g g g g
g w g g g g g
g g w g g g g
g g g w g g g
g g g g w g g
g g g g g w g