h i i i i i f f f f
h i h f i h i f f i
f i h i f i f i f i
w i f f w i i i w f
f f h f f f i f f f
i f f f i f i f i h
f i f i f f i i i i
i i f f i f i f i f
i i f i f i f f f f
f h i i h i i i f i