v v g g g v g v n n
g g g g h v g n v g
v h g g g h n h g g
v v v h g g g g g n
g v h n v g v h g v
n g w w g w w n n w
n n g n g h v v v h
g v h g g g h v g g
g g g g v h v n g g
g g v g v v g v h g