s m s s s s s s s s s s s s s
s s s s s s s s m s s s m s s
s s s m s s s s s s s s s s s
s s s m s m m s s s m s s s s
s s m s s s m s s m m m m m m
m s s m s m s s s s m s s s s
m s s s s s s s s m s s m s s
s s s s s s s s s s s s s m s
s s s s m s s s s s s s s m m
s s s m s s m s m m s m s s s
s s m s s s s s m m s s m s s
s s s m w s w w s s w w m m s
m s s s s s m s m s s s s s s
s m s s s s s s m s s s m s s
s s m s s m s s s s s s s s s