f w w w f f w w f i
f i f f i i h i f f
f f i f i f i f f i
i h f f i f i f f f
f h f h f i i f i i
f i f i h i f i i f
f i h f i h f i i i
h i i i i h f f i i
i i i f i i i f i h
i f i f f i f f f h