f f i i i i i f h f
i f h f f i f f f i
h f f i f f i f i i
i w i w w f f w i h
i i i i f h i f h f
i f f f f f f f i f
i i f i i i h f i i
i h i f f f f i h f
h i h i i f f f i i
h h f i f h f f f f