s m s m s s s s s s
s m s s s m s s s s
m m s m m s s s s s
s s s s m s m s s s
s s s m s m m s s s
s s s s s s s s s s
m m n s s n s w s w
m s s s s s m s s s
s s s m s s s s s s
m s s s s s s s s s