i i f f i f i i i f f i f f f
f f f f f f h f i f f i f f f
i f i f i i f i f f i f f h f
f f h i i f f f i i i i f i f
f f i f f i f h i f f h f f i
w w f i w i f f w i i f w f w
f i f i i f i i f h f h f h f
f h f i i f f f i i i f f f i
f h f f f i i i i i h f f i i
f h f i i f f f f f f h i i i
f f f f i i f f f f f f f h h
i i f h i i f f h i i f i f f
i f f f f f i f f f f f h f h
i f i f i f i i f i i i f h f
i h h f i f f f i f i h i h f