v g g v g v g n h v h v h g h g v g n v v v v g
v g g h g g v v h v g h g g v g v v n v g v g g
g h g v g g g v g v n g v v v v g n g g g g v v
h h g g n n g n v n n v v h n v h v v n g g n g
n g g v v g g h g v g g g g v h v n h g n g v h
g g v h v n g v v v n v g h g g g g g h v g v g
v g h g g g v h v v v v g g v g g n v v g h v v
g h v v g g g v g g v g g v g g g h g v v n g h
g v v h v v g g g v h g v g g v v h v g v g v g
n g n g n g v v v v v v v g h v v g v v g n v h
h h g g g g v v g v g v v v v h h h v v v g v g
g g g v n g g h v v v v g g g g v v g v g v g g
v g v g v g h g v n g v n n v n g n v g g h n h
g v v g v v g h n g v n g g h g g v v g g g g v
v h g v v g v g g v g g g v g g n h h g h v n v
v g g h h g v v n h v g g v v h v g n h v v v n
n v v v v g g h v h g n v v h v v v v g g v v n
n g n g v g g g g g n v g v v g g v g v v v h g
v g v g v v g v g g v n g g h h h g h g g v v g
g g h n v v g v v v v v v n g g h v g v g v g v
g g v g g n g v g n n g g v v v v v v g g g v g
g g v h g v n g v g g h h h v g v v h v v n v g
v v v v g g v g h n n v g v v v g v v h v v v g
g g v v h g v v g g g g g h v v v v n g g v g g