r r p r r r p r r y r r r y y
r y r y y r p y r p r y p y r
r p r y y r y y r r r r y r y
r y r r y y r y y r y y r r p
r p y r y r y r r r y y y y p
r r r r p r r y p y y y r y y
r p y r p r y y y r y y y y y
r r r r p r y y r r y y r r r
r r r y r r y r p y r r r y r
p r y l l r l r l y l p r l r
r y r y y y r r p r y y r r r
r r p r r y y y y y r y r r r
r r r r r p y r y r y r r r r
y r y y r y y r y p y y p r r
r y y y r y y r r r r y p r y