r r y y y p y p
y r p r r r y r
r y y r r y y r
y y r r r r r r
r p y p r y r y
r r r r r r r y
y r r y r y y r
y r y r r p y y