i f f h h i f i
f i i f i i f f
f i f i f h f i
i w w f w h h i
f f i f i f i i
i i h i i f i f
h f f h h f f i
i f f i i i f i