v v v v v g v g g n
h v v v g g g h v g
v h h v v h v v v g
g h g g v n g g v v
w g n g w w w n w v
g h g v v g v v g v
v g n v v v h g v v
g v v g h v v n v n
g g g v g g h g g g
v v g g g n v g v g