s s s s s s s s s s s s m s s
s s s s s m s s s s m s s m s
s m s m s s s m s s s s s s s
s s s s s s s s s s s s s m s
m s s m s s s s s s s s s s s
s s s s s s s s s m s s s s m
s s s s m s m s m s s s m s s
s s s s s m s m s s s s s s s
s m s s s s s s s s s s s s m
m s s s s m s s m s s m s s s
s s s s s s s s s s s s s s m
n w s w s m w s m n w w s m s
m s s m s s s m s s s s s s s
s s m s s m s m m s s s s s s
s s s m s s s s s s s s m m s