m s s s s s s m s m
s s m s s s s s s s
s s m s s s m s s s
s s m s m m s m s s
s s s s s s s s s m
s s s s s m m s s s
s s s m s s m s m s
s s m s s m s s s m
s w w m w m s s s w
s s s s s s s s m s