f h f i i f i h
f i i f f f f f
f f i h f h f i
f f h i h i i f
i i i i i f i f
i i f i i i f h
i w h w w w i w
i i i f i i f i