v g v v v v g n g g
g g g n n v v v h g
w w g w v v v v w w
h h g g h g v g g v
v v g v v h g h v v
g h g v v g g v n v
g g g g g v v v v v
h v g h n n v h h v
h n v v n v h g n v
v v g v n g h v h v