v v v g g g v g
v g h g g g g v
n n w w g g w v
g g n g g h n g
v h v v n v g v
g v g n v v g g
g v v g v g n v
n v v g v v v g