h f f f f i i f
h f f h i f f i
i i f f i f f i
f i h h f f f i
i h i i i i i i
i f f i f f f f
i f i f f w f w
i i i f i i i f