y y r y r y y y r r y y r r r
y r y r r r r y p p p p y y r
r p r r p r y r r r r p y y y
r r r y y r r r r y r r r r y
y r r y r r y p y y p y y r r
y r r p r y y y y y y y r r r
r r r r y y y y r r r r y y p
r r y r y r p p y y r r y r r
r r r y y r y p r r r r y r y
r y y y y r p r y r p y y r r
r y r r y y y r r r r y r r r
y y r y p l r r l r l y p y r
r p r y y r y p y y r r r p y
r r r r r r r r y y y p p r r
r y y r y r y y r r y y y r y