v v w w w w g h v v
h g g n v g h v v g
g v h h g g n v h v
g v v h v v g h n g
h g h h v v g v v v
v g n g g g v n g v
v v v h v v v v g g
g g g g g g g v h v
n g v g g n v v v h
h n g h v v v v n g