n i i f f i f n
i i f i n i f f
f f f w i w n n
n i i f f i f f
i f i i f f i f
n n i i i f i f
f f n n f i n f
f i f f i i i i