g g v g h v v h
v g v g h n v g
w w w w g w n g
h v g v g g v g
g v v g n g v v
g v g v v v v g
g v g g h g v n
v n g v v n v g