r y r r r p y y
r y r y y y r p
y y y r r y r y
r l y r p l l l
y r r r y r y y
r y r y r r y r
y y y p p r r r
r p r y r y p r