s s s s s m s s
s s s s m s s s
m s s s s s m m
m s m s s m m m
w s s s w w m s
s s s s s s s m
s s s m s m m s
s s s s s s s s