v g h v g v v v g h
n v h v g g h n h g
v g g v g v v g v g
g h v g v g g h v h
h g w w v v g v h n
v g v g g h h g n g
v v v g g g v v n v
g v g g v h g v v h
h v n g g v g h v v
v g g g v h h g g g