g v g g g v g h
g v v g g g v g
v h n g g n n v
v w g g h v g g
g v v h v h g v
n g g v g n v g
g n n v v v g v
g v g g v h v g