g g h g v g h v
v v h v v g n h
g v n g g v g g
n g n v h v w w
v h g n h n h g
v v g g v g h v
g v v g g g g g
h g n g g g g g