s s s s s s s s s m
s s s s s s m m m s
m s s s m s m s s s
m m s s s s m m m s
s m s s s s s s s s
w m w w s w w n s m
s s s s s s s s s s
s s s s s s s s s s
s s s m s m s s s s
m s s s s s s s s s