r p p y r r r y
y r y r y y y y
y p y r p r y p
y y y y y y y y
l r y l l r p y
r y r r y p r y
r r r r r r y p
y y y y p r r y