m s s s s s s s s s
s s m s s s s s s s
s s m s s m s s s s
m s s m s m s s s s
w w m s s n n s s w
m s s s s s s s s s
s s s m m s s s s s
s s s s s m s s s s
s s m s s s s s s s
s s m m s s s s s s