y f i i i i f f
f i i i i y i f
i i y i y i f i
i y f f i i f f
i f h y h i i y
i i i f f f f h
f h w i w i w f
h f f y f i f f