s s s s m s s s m s s s m s s
m s s s s m s s s s s s s s m
s s m s m m m s s s s m s s s
s s m m s s s m s m s s s s s
s s s s s m s s s s m m m s s
s s s m s s m s s s s s s s s
s s s s s s m s m s s s s s m
m s s m s s s s s m s s s s s
s s s m m s s s s s s s s s s
s s s m m s m m s s s s s s s
s s s m s s s s s m s s s s s
s s s s s s s s s s s s s s s
m s s s s s m s s s s s s s m
w s s s s w w w s s w s s s w
s m s s m s s m s m s s s s s