g g g g v g g v v v
g v n v g g v n n v
v v v h h v g v v v
g v v v g g n h v g
v g g g v v g n v v
h v g v v v n g g n
h n g v g h v v g g
v h v g w w v v g g
g h n v n v g n g v
v v v v v v g v h v