i f f h i f f i
f i i i i i f i
i i i i h f i i
h f h f w i w w
f f f f h f f h
f f f f i f f i
f i f i i i h f
h f f f h h f h