r p r r y r r r r y
p r y y r r y r y r
r r r r p y r r p r
p r y y y y r y r r
r r r y y r y y r y
l p l r l l l y y r
y p r r y p r y r r
r r p r y p y r r y
r r y p y r r p r r
r y y r y y y r r y