s s m s s s s s m s
m s s s s m m m s s
s m s s s s s s s s
s w s m s n n w s s
s s m m s s s s s s
s s s s s m s m s s
m s s s s m s s s s
s s s s s m m s s s
s s s s s s s s m s
m s s s s m s s m s