s m s m s m s s s s
s s s s m s s m s s
s s s s m s m s m s
m s s s m s s s s s
s w m s m m s s n s
s s s m s s s s s s
s s s s s s s s s s
s s m s s s s s m s
m m m s s s s s m s
s s s s s s s m s s