y r p r r r r y r y r p y r y
r y p p y y y y y y r p r y r
p r y r y p r y r y y r p y y
r y p p r y r y y y r p y y r
y r p y r y y y p p r r y y r
r r p r y p y r r r y y y y y
r r y r y y r r y y y r y y r
r r r r y y p r r y y y y r r
p y y y r y y r y p r p p r r
p y r y r y r r r y r r y y r
l l r l l r l y l l y r l r r
r r r r y r p y p p y r y r r
r r r y r y y y p y r y p r y
r r y r p r y p y y r r y r y
r r r r y p y r y y y p y r p