s s m s s s s s
s s m s m m s s
s s s s s s s s
s s s s s m s s
s s s s s s s m
s s s s s s s m
w w n n n w s s
s s s m s m m s