m m s s m s s m s m
s s m m s s s s s s
w w s n s s s s s s
s s s s s m s s s s
s s s s s s s s s s
s s s s s m m s s s
s s s m m s s s s s
s s s s s s m s s s
s m s s s s s s s m
m m s m s s s s s s