h h i i f f h i i i
f i h h f i i i h i
h f f f i f f h i h
f w i w i f f f f f
i f f f f f f f i i
f f f i f f h f f f
f f f f f f h f f f
f i i f h i f f f i
f i i i f h i i f h
f i i h f f i f f f