i i i f f f f f f i
f f f f f i f i f i
i f i i i f f i f f
i f w w w w w i i h
f f f f h f f f f h
f f i f h f i f f i
i f f i i h f f h h
h f i h i f f i i f
f i i f f f i f i i
f i i h f h i i i f