g v g v n v v v v n
g n v v v v h g g h
w w w w w g w g g v
g v g v g v g h h n
v g n v v n n g v v
g v g v v v n n g h
g v v g h g g h v n
h h h g v g h g g n
g v v v g v n v v v
v h g g g h g v v g