g g g n g n g h
g v g v n n g g
h g v g g v v v
g g n g v v g g
v v g g v v v v
n g v v g g n g
w g w w w g g v
v n v g v v n g