n v v v g n v g h g
n g v v g v n g v v
n h n g g g v g h v
g h g g v g n n v g
g v h h n g v h v v
v v v v w w v g n g
v g v g n v g v v g
h g g v h v n v v v
v n h g v v h g v g
g n g g v v h h g h