s s s s s s s s s s s s s s s
s m s s s s m m s s s s s s s
s w s s w s m s m m w m n m s
m s s m s s m s s m s s s m m
s s s s s s m s s m s s s s s
m s s s s m s s s s s m s s s
s s s s s s s s s m s s s s s
s m s s s s s s m m m m s m m
s m s s m s s s s s s m s m s
s s s s s s m s m s s s m s m
s s s s s m s s s m m s s s m
s s s s m m s s s s s s s s s
s s s s s s s s m s s s s s m
s s s s s m s s s m s s s s s
m s m s s s s s m s s s m s s