m s s s s s s s s s
s m s m s s s s s m
s s m s s m s s s s
s s s s s s s s s s
s s m s s s s s s m
s s s s m s s s s s
s s m s s s s s m s
m w s w n w s w w s
m s m m s s s s s s
s s s s m s s s m m