s s s s s s m m s s
s m s s s m m s m s
m m s s s m s m s s
s s s s m n m w s s
s s s s s s s s m s
s s s s s s s s s s
m s m s s s s s s s
s s s s s s s s m s
s s s m s s m s m s
s s m s s s s s s m