y y r p p y r r p r
y r p r r r r y r r
r p r p r y y r r p
y y y r p r y r r y
y y p p y p y r r r
l l y l l y r r r r
r p y y r r r y y r
y y r y p p y y y y
y p y y r r y p r y
r r r y y r r r r y