s s s s s s s m s s
s m s s s s s s s s
s s s s s s s s s s
m s m s s m s s s s
s s m m s s s m s s
s m s s s s m s s s
s w w w s s s w w s
s m s s s s m s s m
s m s s s m s s s s
s s s m m s s m m m